50 50
3 3
12 26 27 27 27 27 27 27 27 27 27 27 27 28 2 2 2 2 2 2 2 2 2 2 2 2 2 2 2 2 5 2 2 2 2 2 2 2 2 2 2 2 2 2 2 2 2 2 2 2
15 2 1 2 2 2 5 0 2 2 2 2 2 2 2 2 2 2 2 2 2 2 2 2 2 2 2 2 2 2 2 2 2 2 2 2 2 5 2 2 2 2 2 2 2 2 2 2 2 2
15 0 2 1 2 2 2 2 2 2 2 5 2 2 2 5 2 2 5 5 2 2 5 2 2 2 2 5 2 5 2 2 2 2 2 2 2 2 2 2 2 2 2 2 2 2 2 2 2 2
18 2 0 2 0 2 2 3 2 2 2 2 2 2 2 5 2 2 2 2 2 2 5 2 2 2 2 2 2 2 5 2 2 2 2 2 2 2 2 2 2 2 2 2 2 3 2 2 2 2
22 0 2 0 2 2 2 2 2 2 2 2 2 2 2 5 2 2 2 2 2 2 2 2 2 2 2 5 2 2 2 2 2 2 2 2 2 2 2 2 2 2 2 2 2 2 2 2 2 2
25 2 0 5 2 2 2 2 2 2 2 5 1 2 2 5 2 2 20 21 21 21 22 2 2 2 2 2 2 2 2 2 2 2 2 2 2 5 2 2 2 2 2 2 2 2 2 2 2 2
25 0 2 0 2 4 2 2 2 2 8 2 2 2 2 2 2 2 23 24 24 24 25 5 2 5 2 2 2 2 2 2 5 2 2 2 5 2 2 2 2 2 2 2 2 2 2 2 2 2
25 2 0 2 2 2 2 2 2 2 2 2 2 2 2 2 2 2 23 24 24 24 25 2 2 2 2 5 2 5 2 2 2 2 2 6 6 2 2 6 2 2 2 2 2 8 2 2 2 2
25 0 2 2 2 5 2 2 5 2 2 5 2 2 5 2 2 2 23 24 24 24 25 2 5 2 2 2 2 2 2 2 2 5 2 6 6 2 2 2 2 2 2 2 2 2 2 2 2 2
25 2 2 0 2 2 2 2 2 2 2 2 2 2 2 2 2 2 23 24 24 24 25 2 2 2 5 2 2 2 2 2 2 2 2 2 5 2 2 2 2 2 2 2 2 2 2 2 2 2
28 2 2 6 2 2 2 2 2 5 2 5 2 2 2 2 2 2 23 24 24 24 25 2 2 2 2 2 2 2 2 2 2 2 2 2 2 2 2 2 2 2 2 2 2 2 2 2 2 2
12 2 2 2 2 5 2 5 2 2 5 2 2 2 2 2 2 2 26 27 27 27 28 2 2 2 2 2 2 2 2 2 2 2 2 2 2 2 2 2 2 2 2 2 2 2 2 2 2 2
15 2 2 7 2 2 2 2 2 2 2 2 2 2 2 2 2 2 2 2 2 2 2 2 2 2 2 2 2 2 2 2 2 2 2 2 2 2 2 2 2 2 2 2 2 2 2 2 2 2
15 2 2 2 2 2 2 2 2 5 2 2 2 2 2 2 2 2 2 2 2 2 2 5 2 2 2 2 2 2 2 2 5 2 2 2 2 2 2 2 2 2 2 2 2 2 2 2 2 2
15 2 5 2 2 2 2 2 2 2 2 2 2 2 2 2 2 2 2 3 3 2 2 2 2 2 2 2 2 2 2 2 2 2 2 2 2 2 2 2 2 2 2 2 2 2 2 2 2 2
15 2 2 2 2 2 2 2 2 5 2 5 2 2 2 2 2 2 2 2 2 2 2 2 2 2 2 2 2 2 5 2 2 2 2 2 2 2 2 2 2 2 2 2 2 2 2 2 2 2
15 2 2 2 2 2 2 2 2 2 2 2 2 2 2 2 2 2 2 2 2 2 2 2 2 2 2 2 2 2 2 2 2 2 2 2 2 2 2 2 2 2 2 8 2 2 2 2 1 2
15 2 2 2 2 2 2 2 2 2 2 2 5 2 2 2 2 2 2 2 2 2 2 2 2 2 3 2 2 2 2 2 2 2 8 2 2 2 4 4 2 2 2 2 2 2 2 2 2 2
15 2 2 2 5 2 2 2 2 2 2 2 2 2 5 2 2 5 2 2 2 2 2 2 2 2 2 2 2 2 2 2 2 2 2 2 2 2 2 2 2 2 2 2 2 2 2 1 2 2
15 2 5 2 2 2 2 2 2 5 2 2 2 2 2 2 2 2 2 2 2 2 2 2 2 2 2 2 2 2 5 2 2 2 2 2 2 2 2 2 2 2 2 7 2 2 2 2 2 2
15 2 2 2 2 2 2 2 2 2 2 2 2 2 2 2 2 8 2 2 2 2 4 2 2 2 2 2 2 2 2 2 2 2 2 2 2 3 3 2 2 2 2 2 1 2 2 2 2 2
15 2 2 2 2 2 2 2 2 2 2 2 2 2 2 2 2 6 6 2 2 2 2 2 2 2 8 2 2 2 2 2 2 2 2 2 2 6 6 2 2 2 2 2 2 2 2 2 2 2
15 2 2 10 11 11 12 2 2 2 2 2 2 2 2 2 5 2 3 2 2 2 2 2 2 2 2 5 2 2 2 2 2 2 2 2 2 2 2 2 2 2 2 2 2 2 2 2 2 1
15 2 2 13 14 14 15 2 2 2 2 2 2 2 2 8 2 2 2 2 2 2 2 2 2 2 2 2 2 2 2 2 2 2 2 2 2 2 2 2 2 1 2 2 2 2 2 2 2 1
15 2 2 13 14 14 15 2 2 2 2 2 2 2 2 2 2 2 2 2 2 2 2 2 2 2 2 7 2 2 2 2 2 2 4 2 2 2 2 2 2 2 2 2 2 2 1 2 2 1
15 2 2 13 14 14 15 2 2 2 2 2 2 2 2 2 2 2 1 2 2 2 8 2 2 2 2 2 2 2 2 2 2 2 2 2 2 2 1 2 2 2 1 2 2 2 2 2 2 2
15 2 2 13 14 14 15 2 2 2 2 2 2 4 2 2 2 2 2 2 2 2 2 2 2 2 2 2 2 2 1 2 2 2 2 2 2 2 2 2 2 2 2 2 2 2 2 2 2 2
15 2 2 13 14 14 15 2 2 2 2 2 2 2 2 2 2 2 1 8 2 2 2 2 2 2 2 2 2 2 1 2 2 1 2 2 2 2 2 2 2 1 2 2 2 2 2 2 1 2
15 2 2 16 17 17 18 2 2 2 2 2 2 2 2 2 2 2 2 2 2 2 2 2 2 2 2 2 2 2 1 2 2 2 2 2 2 2 2 2 2 2 2 2 2 2 2 2 2 2
15 2 2 1 2 2 2 2 2 2 2 2 2 2 2 2 2 2 2 2 1 2 2 3 2 2 2 2 2 2 2 2 1 2 2 2 2 2 2 2 2 2 2 2 2 2 2 2 2 2
15 2 2 1 2 2 2 2 2 2 2 2 2 2 2 2 2 2 2 2 2 2 2 2 2 2 2 2 2 2 2 2 2 2 2 2 2 2 2 2 2 1 2 2 2 2 2 2 2 2
15 2 2 1 2 2 2 2 2 2 2 2 2 2 2 3 3 2 2 2 1 2 2 2 2 2 2 2 2 2 2 7 2 2 2 2 2 2 2 2 2 2 4 2 2 6 6 2 2 2
15 2 2 1 2 2 2 2 2 2 2 2 2 2 2 3 3 2 2 2 2 2 2 2 2 2 2 2 2 2 2 2 2 2 2 4 2 2 7 2 2 2 2 2 2 2 2 2 2 2
15 2 2 1 2 2 2 2 2 2 2 2 2 2 2 2 2 2 2 2 2 2 2 4 3 2 2 2 2 2 2 2 2 2 2 2 2 2 2 2 2 2 2 2 2 2 2 2 2 2
15 2 2 1 2 2 2 2 2 2 2 2 2 2 2 2 2 2 2 2 2 2 2 2 2 2 2 2 4 2 2 2 2 2 2 2 2 2 2 2 4 2 2 4 4 2 2 2 2 2
15 2 2 1 2 2 2 9 2 2 2 2 2 2 2 2 2 2 2 2 2 2 2 2 2 2 2 2 2 2 2 2 2 2 2 2 2 2 2 2 2 2 2 5 2 2 2 2 2 2
15 2 2 1 2 2 2 2 2 2 2 2 2 9 2 2 2 2 2 2 2 2 7 2 2 2 2 4 2 2 2 2 2 2 2 4 2 2 2 2 2 2 2 2 2 2 2 2 2 2
15 2 2 1 2 2 2 2 2 2 3 2 2 2 2 2 2 2 2 2 2 2 2 2 2 2 2 2 2 2 2 2 2 2 2 2 2 2 2 2 2 2 6 6 2 2 2 2 2 2
15 2 2 1 2 2 2 2 2 2 2 2 2 2 2 2 2 2 2 4 2 2 2 2 5 2 2 2 3 3 2 2 3 6 2 2 2 2 2 2 2 2 6 6 2 2 2 2 2 2
15 2 2 1 2 2 2 9 2 2 2 2 2 2 2 2 2 2 9 2 3 3 2 2 2 2 2 2 6 6 2 2 6 3 2 2 2 2 2 2 2 2 2 2 2 2 2 2 2 2
15 2 2 1 2 2 2 2 2 2 6 2 2 2 2 2 2 2 2 2 3 3 2 2 2 2 8 2 3 3 2 2 2 2 2 2 2 2 2 2 2 3 3 2 2 2 2 2 2 2
15 2 2 1 2 2 2 2 2 2 2 2 2 2 2 2 2 2 2 2 2 3 3 2 2 2 2 2 6 6 2 2 2 2 2 2 2 1 2 2 2 2 2 2 2 2 2 2 2 2
15 2 2 1 2 2 2 2 2 2 2 2 2 2 2 2 2 2 2 2 2 3 3 2 2 2 2 2 2 2 2 2 2 2 2 2 2 1 2 2 2 2 2 2 2 2 2 2 2 2
15 2 2 1 2 2 2 2 2 2 2 2 2 4 2 2 2 4 2 2 2 2 2 8 2 2 1 2 2 2 2 2 2 2 2 2 2 6 2 2 2 2 2 2 2 2 2 2 2 2
15 2 2 1 2 2 2 2 2 2 2 2 2 2 8 2 2 2 2 2 2 2 2 2 2 2 1 2 2 8 2 2 2 2 2 2 2 5 2 2 2 2 2 2 2 2 2 2 2 2
15 2 2 1 2 2 2 2 2 2 2 2 2 2 2 3 2 2 2 8 2 2 2 2 2 2 2 2 2 2 2 2 2 2 2 2 2 2 2 2 2 2 2 2 2 2 2 2 2 2
15 2 2 1 2 2 2 2 2 2 2 2 2 6 3 2 2 2 2 2 2 2 2 2 2 2 2 2 2 2 2 2 2 2 8 2 2 2 2 2 2 2 2 2 2 2 2 2 2 2
15 2 2 1 2 2 5 2 6 6 2 2 2 3 6 2 2 2 3 2 2 3 3 2 2 2 2 2 2 2 2 2 2 2 2 2 2 2 2 2 2 2 2 2 2 2 2 2 2 2
15 2 2 1 2 2 2 2 6 6 2 2 2 2 2 2 2 2 2 4 2 3 3 2 2 2 2 2 2 2 2 2 2 2 2 2 2 2 2 2 2 2 2 2 2 8 2 2 2 2
15 2 2 2 2 2 2 2 2 2 2 2 2 2 2 2 2 2 2 2 2 2 2 2 2 2 2 2 2 2 2 2 2 2 2 2 2 2 2 2 2 2 2 2 2 2 2 2 2 8

